111111111111111111111111111111111111111111111111111111111111111
1P00000000000000000000000000000000000000000000000000000000000E1
100000000000000000000000000000000000000000000000000000000000001
100000000000000000000000000000000000000000000000000000000000001
100000000000000000000000000000000000000000000000000000000000001
10000000000000000P000000000000000000000000000000000000000000001
100000011111111111111111111111000000000000000000000000000000001
1000000000000C0C0C0C0C0C0C0C01000000000000000000000000000000001
100000000000000000000000000C01000000000000000000000000000000001
100000000000000000000000000C01000000000000000000000000000000001
100000000000000000000000000C01000000000000000000000000000000001
100000000000000000000000000C01000000000000000000000000000000001
100000000000000000000000000C01111111111111111111000000000000001
1000000000000000000000000000C0C0C0C0C0C0C0C0C0C1000000000000001
100000000000000000000000000000000000000000000001000000000000001
100000000000000000000000000000000000000000000001111010101010001
1E00000000000000000000000000000000000000000000000001010101010E1
111111111111111111111111111111111111111111111111111111111111111