11111111111111111111111111111111111111111111111111
1E000000000000000000000000000000000000000000000001
10000000000000000000000000000000000000000000000001
10000000000000000000000000000000000000000000000001
10000000000000000000000000000000000000000000000001
10000000000000000000000000000000000000000000000001
10000001111111111111111111111100000000000000000001
1000000000000C0C0C0C0C0C0C0C0100000000000000000001
100000000000000000000000000C0100000000000000000001
100000000000000000000000000C0100000000000000000001
10000P000000000000000000000C0100000000000000000001
100000000000000000000000000C0100000000000000000001
100000000000000C0111111111111111111100000000000001
100000000000000C0C0C0C0C0C0C0C0C0C1000000000000001
10000000000000000000000000000000001000000000000001
10000000000000000000000000000000001111010101010001
1E000000000000000000000000000000000000000000000001
11111111111111111111111111111111111111111111111111